10
.S........
..##......
..........
..........
...##.....
..#.......
..........
..........
.#####....
.#G.......