25
.#.....######............
.#....##............##...
##...#.....##........##..
#...#........###......##.
#...#...........###....#.
#...#....####.....#....#.
#...#...##.........#....#
#...#..##..........#....#
#...#..#...###.....#....#
#...#..#.....##.....#...#
#...#..##...S.#.....#....
#...#...#.....#.....#....
#...#...##..###.....#....
#...##...##........##....
#....#....##.......#.....
#.....#....###....##.....
#................##....#.
#...##..........##...##..
.#...##............##....
.#....###..........#.....
.##.....###.......##..###
..##......##......#..##..
...##.............#..#...
....#.............#..##..
..................#.....G
